NO ./textures/NO.xpm
SO ./textures/SO.xpm
WE ./textures/WE.xpm
EA ./textures/EA.xpm

C 182,213,240
F 0,57,22



111
101
101
111
111111111111111111
100000000000000101
100000000000000101
100000000000000001
100000000000000001
100011000000000101
100011000000000001
100000000000000001
100000000000000001
100000000000000001
1000N0000000000001
100000000000000001
100000000000000001
111111111111111111