NO ./textures/NO.xpm
SO ./textures/SO.xpm
WE ./textures/WE.xpm
EA ./textures/EA.xpm
F 182,213,240
C 0,57,22


111111111111111111
100000000000000001
100000000000000001
100000000000000001
100011000000000001
100011000000000001
100000000000000001
1000000000000000N1
111111111111111111