NO ./path_to_the_north_texture
SO ./path_to_the_south_texture
WE ./path_to_the_west_texture
EA ./path_to_the_east_texture
F 182,213,240
C 0,57,22

1111111111
1000000001
1000000001
100N000001
1000000001
1000000001
1000000001
1000000001
1000000001
1111111111