NO /Users/19658306/school/cub/textures/NO.xpm
SO /Users/19658306/school/cub/textures/SO.xpm
WE /Users/19658306/school/cub/textures/WE.xpm
EA /Users/19658306/school/cub/textures/EA.xpm
F 182,213,240
C 0,57,22

1111111111
1111000001
1000000001
1000000001
1000000001
1000000001
1000000001
1000000001
1000000001
11110000N1
1111111111